1111111111111111
100000PCE0000001
1111111111111111