111111111111
10000PCE0001
111111111111
