111111111111
10000PCE00011
111111111111
